%%%%%%%%%%%%%%%%%%%%%%%%%%%%%%
%                            %
%                            %
%                            %
%                            %
%                            %
%                            %
%                            %
%                            %
%                            %
%                            %
%                            %
%                            %
%                            %
%                            %
%                            %
%                            %
%%%%%%%%%%%%%%%%%%%%%%%%%%%%%%
% % % % % % %%%%%%%%%%%%%%%%%%
%%%%%%%%%%%%%%%%%%%%%%%%%%%%%%